9 9
110111111
100167891
100122341
100111111
000000000
100000001
100000001
150000001
110111111