8 8
11111111
10067891
10000001
10234001
10000001
10000001
15000001
11111111