8 8
11111111
10067891
10000001
10111101
10111101
10223401
15000001
11111111